{
	"hashcode": 23553,
	"board": [
		[6,7,3, 1,2,4, 8,5,9],
		[4,8,1, 7,5,9, 2,6,3],
		[5,9,2, 6,8,3, 1,4,7],

		[2,6,4, 8,7,5, 3,9,1],
		[8,1,9, 4,3,2, 6,7,5],
		[3,5,7, 9,6,1, 4,8,2],

		[7,3,8, 5,1,6, 9,2,4],
		[1,4,5, 2,9,8, 7,3,6],
		[9,2,6, 3,4,7, 5,1,8]
	],
	"display": [
		[0,1,0, 0,1,0, 1,0,0],
		[0,0,1, 0,0,0, 1,0,0],
		[1,1,0, 0,0,1, 0,1,0],

		[0,0,0, 1,1,0, 0,1,0],
		[1,0,0, 0,0,0, 1,1,0],
		[1,0,0, 1,0,1, 0,0,0],
		
		[0,0,0, 0,0,0, 1,0,0],
		[0,0,0, 1,1,1, 0,0,1],
		[0,0,1, 0,1,1, 0,0,0]
	]
}