{
	"hashcode": 60633,
	"board": [
		[2,9,8, 7,6,4, 5,1,3],
		[7,3,4, 9,5,1, 2,8,6],
		[1,5,6, 8,2,3, 9,4,7],

		[4,7,2, 1,3,9, 6,5,8],
		[6,1,9, 5,8,2, 7,3,4],
		[3,8,5, 6,4,7, 1,9,2],

		[8,2,7, 4,9,5, 3,6,1],
		[9,4,1, 3,7,6, 8,2,5],
		[5,6,3, 2,1,8, 4,7,9]
	],
	"display": [
		[0,1,0, 1,1,0, 0,0,1],
		[0,0,0, 0,0,1, 0,0,0],
		[1,0,0, 0,0,0, 0,1,0],

		[0,1,0, 1,1,0, 0,0,0],
		[0,1,0, 0,1,1, 1,0,0],
		[0,0,0, 0,0,0, 0,1,0],
		
		[1,0,0, 0,1,1, 0,0,1],
		[0,0,0, 0,0,0, 0,1,1],
		[0,1,1, 0,1,1, 0,0,0]
	]
}