{
	"hashcode": 8253,
	"board": [
		[7,4,6, 2,9,5, 1,3,8],
		[3,1,8, 4,7,6, 5,9,2],
		[5,2,9, 3,1,8, 6,7,4],

		[8,3,7, 5,4,1, 9,2,6],
		[2,9,4, 6,8,3, 7,5,1],
		[6,5,1, 9,2,7, 4,8,3],

		[9,6,5, 1,3,2, 8,4,7],
		[4,7,3, 8,6,9, 2,1,5],
		[1,8,2, 7,5,4, 3,6,9]
	],
	"display": [
		[0,1,0, 0,1,0, 1,1,0],
		[0,0,1, 0,0,0, 0,0,0],
		[1,0,0, 0,0,0, 0,0,1],

		[0,1,0, 1,1,0, 0,1,0],
		[1,0,0, 0,0,0, 0,0,0],
		[1,0,1, 0,0,0, 1,0,0],
		
		[0,0,0, 1,1,0, 0,0,0],
		[0,0,1, 1,0,0, 0,0,1],
		[0,0,1, 0,0,1, 1,1,1]
	]
}