{
	"hashcode": 83133,
	"board": [
		[2,4,6, 8,7,1, 9,3,5],
		[1,5,3, 2,9,4, 6,8,7],
		[7,8,9, 3,5,6, 2,4,1],

		[6,1,8, 5,4,2, 7,9,3],
		[9,7,4, 1,8,3, 5,6,2],
		[5,3,2, 7,6,9, 4,1,8],

		[3,9,1, 6,2,5, 8,7,4],
		[8,6,5, 4,1,7, 3,2,9],
		[4,2,7, 9,3,8, 1,5,6]
	],
	"display": [
		[0,0,0, 1,1,0, 1,1,0],
		[1,1,0, 0,0,0, 0,0,1],
		[0,0,1, 0,0,0, 0,0,0],

		[1,1,1, 0,1,0, 1,0,0],
		[1,0,0, 0,0,1, 0,0,1],
		[0,0,0, 1,0,0, 1,0,0],
		
		[0,1,0, 0,0,1, 1,0,0],
		[0,0,1, 0,1,0, 0,0,0],
		[0,1,0, 1,0,0, 0,0,1]
	]
}