{
	"hashcode": 31203,
	"board": [
		[8,3,5, 1,9,6, 2,7,4],
		[2,1,9, 7,4,5, 8,6,3],
		[7,6,4, 3,8,2, 9,1,5],

		[5,9,3, 2,6,8, 1,4,7],
		[1,4,8, 9,3,7, 5,2,6],
		[6,7,2, 5,1,4, 3,9,8],

		[9,8,7, 4,5,1, 6,3,2],
		[3,2,6, 8,7,9, 4,5,1],
		[4,5,1, 6,2,3, 7,8,9]
	],
	"display": [
		[0,0,1, 0,1,0, 0,0,0],
		[1,1,0, 0,0,0, 1,0,0],
		[1,1,0, 0,1,0, 0,0,0],

		[1,0,1, 0,0,1, 0,0,1],
		[1,0,0, 1,0,0, 0,0,0],
		[0,1,0, 0,0,0, 1,0,1],
		
		[1,0,0, 1,0,1, 0,0,1],
		[0,0,0, 0,0,1, 0,1,0],
		[0,0,0, 1,0,0, 1,0,0]
	]
}