{
	"hashcode": 3577,
	"board": [
		[3,7,6, 1,9,8, 5,2,4],
		[9,5,2, 6,4,7, 1,3,8],
		[1,8,4, 5,3,2, 6,7,9],

		[2,1,9, 8,7,4, 3,5,6],
		[4,6,8, 2,5,3, 7,9,1],
		[5,3,7, 9,6,1, 8,4,2],

		[6,2,5, 7,1,9, 4,8,3],
		[8,4,1, 3,2,5, 9,6,7],
		[7,9,3, 4,8,6, 2,1,5]
	],
	"display": [
		[0,0,0, 0,1,1, 0,0,0],
		[0,0,1, 0,1,0, 1,0,1],
		[0,0,0, 1,1,0, 1,0,0],

		[0,1,0, 0,0,0, 1,0,0],
		[1,0,0, 0,0,0, 0,1,0],
		[1,1,1, 0,0,0, 1,0,1],
		
		[0,0,0, 1,0,0, 0,1,0],
		[1,0,0, 0,0,1, 0,0,0],
		[1,1,0, 0,0,0, 0,0,1]
	]
}