{
	"hashcode": 727848,
	"board": [
		[1,2,3,4,5,6,7,8,9],
		[1,2,3,4,5,6,7,8,9],
		[1,2,3,4,5,6,7,8,9],
		[1,2,3,4,5,6,7,8,9],
		[1,2,3,4,5,6,7,8,9],
		[1,2,3,4,5,6,7,8,9],
		[1,2,3,4,5,6,7,8,9],
		[1,2,3,4,5,6,7,8,9],
		[1,2,3,4,5,6,7,8,9]
	],
	"display": [
		[1,0,1,1,0,1,1,0,1],
		[1,0,1,1,0,1,1,0,1],
		[1,0,1,1,0,1,1,0,1],
		[1,0,1,1,0,1,1,0,1],
		[1,0,1,1,0,1,1,0,1],
		[1,0,1,1,0,1,1,0,1],
		[1,0,1,1,0,1,1,0,1],
		[1,0,1,1,0,1,1,0,1],
		[1,0,1,1,0,1,1,0,1]
	],
	"MatchHistory": [
		{
			"won": true,
			"moves": 15,
			"date": "2018-01-15 14:12",
			"elapsedSeconds": 9012
		},
		{
			"won": false,
			"moves": 742,
			"date": "2018-01-14 18:44",
			"elapsedSeconds": 102063
		}
	]
}