{
	"hashcode": 14117,
	"board": [
		[7,6,3, 9,1,2, 4,8,5],
		[2,8,9, 3,5,4, 1,7,6],
		[4,5,1, 7,6,8, 3,2,9],

		[5,7,8, 6,3,1, 2,9,4],
		[6,3,4, 5,2,9, 8,1,7],
		[9,1,2, 8,4,7, 6,5,3],

		[8,2,6, 4,7,5, 9,3,1],
		[1,4,7, 2,9,3, 5,6,8],
		[3,9,5, 4,8,6, 7,4,2]
	],
	"display": [
		[0,1,0, 0,1,0, 1,0,1],
		[1,0,1, 0,0,0, 0,0,1],
		[0,1,0, 0,0,1, 0,0,0],

		[0,1,0, 1,1,0, 0,1,0],
		[1,0,0, 1,0,1, 1,0,0],
		[0,1,1, 0,0,1, 1,0,0],
		
		[0,0,0, 1,1,0, 1,0,0],
		[1,0,1, 0,0,0, 0,0,1],
		[0,0,1, 0,0,0, 1,0,0]
	]
}