{
	"hashcode": 213768,
	"board": [
		[9,8,7,6,5,4,3,2,1],
		[9,8,7,6,5,4,3,2,1],
		[9,8,7,6,5,4,3,2,1],
		[9,8,7,6,5,4,3,2,1],
		[9,8,7,6,5,4,3,2,1],
		[9,8,7,6,5,4,3,2,1],
		[9,8,7,6,5,4,3,2,1],
		[9,8,7,6,5,4,3,2,1],
		[9,8,7,6,5,4,3,2,1]
	],
	"display": [
		[1,0,0,1,0,0,1,0,0],
		[0,1,0,0,1,0,0,1,0],
		[0,0,1,0,0,1,0,0,1],
		[1,0,0,1,0,0,1,0,0],
		[0,1,0,0,1,0,0,1,0],
		[0,0,1,0,0,1,0,0,1],
		[1,0,0,1,0,0,1,0,0],
		[0,1,0,0,1,0,0,1,0],
		[0,0,1,0,0,1,0,0,1]
	],
	"MatchHistory": [
		{
			"won": true,
			"moves": 15,
			"date": "2015-08-15 23:32",
			"elapsedSeconds": 777
		},
		{
			"won": false,
			"moves": 72,
			"date": "2010-04-15 12:44",
			"elapsedSeconds": 1020
		}
	]
}