{
	"hashcode": 22517,
	"board": [
		[8,3,9, 7,5,1, 2,4,6],
		[6,7,2, 3,9,4, 5,8,1],
		[4,1,5, 8,6,2, 9,7,3],

		[9,8,7, 6,4,3, 1,5,2],
		[5,2,4, 9,1,7, 3,6,8],
		[1,6,3, 2,8,5, 4,9,7],

		[2,5,8, 4,3,6, 7,1,9],
		[7,9,1, 5,2,8, 6,3,4],
		[3,4,6, 1,7,9, 8,2,5]
	],
	"display": [
		[0,0,1, 1,1,0, 0,0,0],
		[0,0,0, 0,1,0, 0,1,1],
		[0,0,0, 1,0,0, 0,0,1],

		[0,0,1, 0,0,1, 0,0,1],
		[1,0,1, 1,0,0, 0,1,0],
		[1,0,0, 0,0,0, 1,0,0],
		
		[0,0,0, 1,0,0, 0,1,1],
		[1,0,0, 0,0,1, 0,0,0],
		[1,0,0, 0,0,0, 0,0,0]
	]
}