{
	"board": [
		[1,2,3,4,5,6,7,8,9],
		[9,1,2,3,4,5,6,7,8],
		[8,9,1,2,3,4,5,6,7],
		[7,8,9,1,2,3,4,5,6],
		[6,7,8,9,1,2,3,4,5],
		[5,6,7,8,9,1,2,3,4],
		[4,5,6,7,8,9,1,2,3],
		[3,4,5,6,7,8,9,1,2],
		[2,3,4,5,6,7,8,9,1]
	],
	"display": [
		[0,1,0,0,0,0,1,0,0],
		[0,1,0,1,0,0,0,0,0],
		[0,0,0,0,1,0,0,0,0],
		[0,0,0,0,0,0,1,0,0],
		[1,0,0,1,0,0,0,0,0],
		[0,0,0,0,0,0,1,0,0],
		[0,1,0,0,0,0,0,0,0],
		[0,0,0,0,1,0,0,1,0],
		[0,0,0,0,0,1,0,0,0]
	],
	"MatchHistory": [
		{
			"won": true,
			"moves": 15,
			"date": "2019-12-01 09:59",
			"elapsedSeconds": 77777
		}
	]
}