{
	"hashcode": 3317,
	"board": [
		[8,1,5, 3,4,6, 7,9,2],
		[3,4,2, 9,1,7, 5,8,6],
		[9,7,6, 5,8,2, 3,4,1],

		[1,3,4, 6,7,8, 2,5,9],
		[5,2,7, 4,9,1, 8,6,3],
		[6,9,8, 2,5,3, 4,1,7],

		[7,5,1, 8,3,9, 6,2,4],
		[2,8,3, 1,6,4, 9,7,5],
		[4,6,9, 7,2,5, 1,3,8]
	],
	"display": [
		[0,0,1, 1,0,0, 1,0,0],
		[0,0,0, 1,1,0, 0,0,1],
		[1,0,0, 0,0,1, 1,1,0],

		[0,1,1, 0,0,1, 0,1,1],
		[0,0,1, 0,0,0, 0,0,0],
		[0,0,1, 0,0,0, 0,0,0],
		
		[0,0,0, 0,1,0, 1,0,0],
		[1,0,0, 0,0,1, 0,0,0],
		[0,1,0, 1,0,0, 1,0,0]
	]
}