{
	"hashcode": 46577,
	"board": [
		[3,7,9, 5,2,8, 6,1,4],
		[2,5,6, 9,4,1, 8,3,7],
		[8,1,4, 7,3,6, 5,2,9],

		[9,8,5, 4,6,3, 2,7,1],
		[1,4,7, 2,8,5, 9,6,3],
		[6,3,2, 1,9,7, 4,5,8],

		[7,9,8, 3,5,2, 1,4,6],
		[4,2,3, 6,1,9, 7,8,5],
		[5,6,1, 8,7,4, 3,9,2]
	],
	"display": [
		[1,0,1, 1,0,0, 0,0,0],
		[1,0,1, 1,0,0, 0,1,0],
		[0,1,0, 0,0,0, 0,1,0],

		[0,1,0, 1,0,1, 0,0,0],
		[1,1,0, 0,0,0, 0,0,0],
		[1,0,0, 1,0,1, 1,0,0],
		
		[0,0,0, 1,1,1, 1,0,0],
		[1,0,1, 1,0,0, 1,0,1],
		[1,0,0, 0,0,0, 0,0,1]
	]
}