{
	"hashcode": 53597,
	"board": [
		[2,5,6, 4,9,8, 3,1,7],
		[1,4,8, 2,7,3, 5,9,6],
		[3,9,7, 1,5,6, 8,2,4],

		[5,1,9, 6,2,7, 4,3,8],
		[6,8,3, 9,4,1, 7,5,2],
		[4,7,2, 3,8,5, 9,6,1],

		[9,3,1, 8,6,4, 2,7,5],
		[7,6,4, 5,3,2, 1,8,9],
		[8,2,5, 7,1,9, 6,4,3]
	],
	"display": [
		[0,0,0, 1,0,0, 0,1,0],
		[0,1,1, 1,0,0, 0,0,1],
		[0,1,0, 1,0,0, 1,0,0],

		[0,1,0, 1,0,1, 0,0,0],
		[0,1,1, 0,0,0, 1,0,1],
		[1,0,0, 0,0,0, 0,0,0],
		
		[0,0,0, 0,1,1, 0,1,0],
		[0,0,0, 1,1,0, 0,0,1],
		[0,0,0, 0,0,0, 0,1,0]
	]
}