{
	"hashcode": 64127,
	"board": [
		[5,9,7, 8,3,2, 4,1,6],
		[4,1,8, 9,6,5, 3,7,2],
		[3,6,2, 7,1,4, 5,9,8],

		[2,5,1, 3,9,8, 6,4,7],
		[7,8,4, 6,2,1, 9,3,5],
		[9,3,6, 4,5,7, 2,8,1],

		[1,2,3, 5,7,9, 8,6,4],
		[8,7,9, 2,4,6, 1,5,3],
		[6,4,5, 1,8,3, 7,2,9]
	],
	"display": [
		[0,0,1, 0,0,0, 1,0,0],
		[0,1,0, 0,1,1, 0,0,0],
		[1,1,1, 1,1,0, 0,0,0],

		[1,0,1, 0,0,1, 0,1,1],
		[0,1,0, 1,1,0, 0,0,0],
		[1,0,0, 0,0,1, 0,0,0],
		
		[0,0,0, 0,0,0, 1,1,1],
		[0,1,0, 0,0,1, 1,1,1],
		[0,0,0, 0,1,0, 0,0,0]
	]
}