{
	"hashcode": 9137,
	"board": [
		[5,1,8, 4,7,9, 2,3,6],
		[9,4,2, 5,6,3, 8,1,7],
		[7,3,6, 8,2,1, 9,5,4],

		[6,2,5, 3,1,7, 4,9,8],
		[1,7,9, 2,4,8, 3,6,5],
		[4,8,3, 9,5,6, 1,7,2],

		[2,9,4, 7,3,5, 6,8,1],
		[8,5,1, 6,9,2, 7,4,3],
		[3,6,7, 1,8,4, 5,2,9]
	],
	"display": [
		[0,1,1, 0,0,0, 0,0,1],
		[0,0,0, 0,0,1, 0,1,1],
		[0,0,1, 1,1,0, 0,1,0],

		[1,1,1, 0,0,0, 1,1,0],
		[0,0,0, 0,0,1, 0,0,1],
		[0,0,1, 0,0,0, 0,0,0],
		
		[1,0,0, 0,0,0, 0,1,1],
		[0,1,0, 1,1,0, 0,0,0],
		[0,1,0, 0,0,1, 0,0,0]
	]
}